datetime,shortId,shortGroup,description,type,kind,isRefund,isRefunded,shortRefundId,displayAmount,amount,paymentProcessorFee,netAmount,balance,currency,accountSlug,accountName,oppositeAccountSlug,oppositeAccountName,paymentMethodService,paymentMethodType,expenseType,expenseTags,payoutMethodType,merchantId,orderMemo,taxAmount,oppositeAccountEmail
2024-04-11T00:18:42,a4e4dafc,9a69f489,Transaction to Stripe,DEBIT,PAYMENT_PROCESSOR_FEE,,,,-CA$1.75 CAD,-1.75,0,-1.75,13933.51,CAD,slug,Aname,stripe-payment-processor-vendor,Stripe,STRIPE,CREDITCARD,,,,,,,
2024-04-11T00:18:42,37fcfe54,9a69f489,Yearly contribution from Ralimba (Member),CREDIT,CONTRIBUTION,,,,CA$50.00 CAD,50,0,50,13935.26,CAD,slug,Aname,redacted,Ralph Redacted,STRIPE,CREDITCARD,,,,,,,email1
2024-04-05T00:02:49,48aa5a86,c82474f4,Transaction to Stripe,DEBIT,PAYMENT_PROCESSOR_FEE,,,,-CA$1.97 CAD,-1.97,0,-1.97,13885.26,CAD,slug,Aname,stripe-payment-processor-vendor,Stripe,STRIPE,CREDITCARD,,,,,,,
2024-04-05T00:02:49,cba426e9,c82474f4,Yearly contribution from emergencydoc (Member),CREDIT,CONTRIBUTION,,,,CA$50.00 CAD,50,0,50,13887.23,CAD,slug,Aname,redacted,Eddie Redacted,STRIPE,CREDITCARD,,,,,,,email2
2024-04-03T14:21:27,f612f742,9e46c1f1,Transaction to Stripe,DEBIT,PAYMENT_PROCESSOR_FEE,,,,-CA$1.97 CAD,-1.97,0,-1.97,13837.23,CAD,slug,Aname,stripe-payment-processor-vendor,Stripe,STRIPE,CREDITCARD,,,,,,,
2024-04-03T14:21:27,eb12e385,9e46c1f1,Yearly contribution from Michele (Member),CREDIT,CONTRIBUTION,,,,CA$50.00 CAD,50,0,50,13839.2,CAD,slug,Aname,guest-10c369c5,Sally Redacted,STRIPE,CREDITCARD,,,,,,,email3
2024-04-01T21:54:01,b4f3c521,65987675,Transaction to Stripe,DEBIT,PAYMENT_PROCESSOR_FEE,,,,-CA$1.90 CAD,-1.9,0,-1.9,13789.2,CAD,slug,Aname,stripe-payment-processor-vendor,Stripe,STRIPE,CREDITCARD,,,,,,,
2024-04-01T21:54:01,046781c7,65987675,Yearly contribution from Bruce Elrick (Member),CREDIT,CONTRIBUTION,,,,CA$50.00 CAD,50,0,50,13791.1,CAD,slug,Aname,redacted,Roger Redacted,STRIPE,CREDITCARD,,,,,,,email4
2024-04-01T20:26:41,252e3ea5,305ca6e5,Transaction to Stripe,DEBIT,PAYMENT_PROCESSOR_FEE,,,,-CA$1.97 CAD,-1.97,0,-1.97,13741.1,CAD,slug,Aname,stripe-payment-processor-vendor,Stripe,STRIPE,CREDITCARD,,,,,,,